+-+-+-+-+-+-+-+-+-+-+-+-+-+-+-+-+-+-+-+-+-+-+-+-+-+-+-+-+-+-+
| |               |     |   | | |   | | | |     |           |
+ + + + + +-+ + + +-+-+ + + + + + +-+ + + + + + + +-+-+ + +-+
| | | | |   | | |       | | |   |     | | | | | |   |   |   |
+ +-+ + + +-+ +-+-+-+ + + +-+-+ +-+-+ + + + +-+ +-+ + + +-+ +
|     | | | |   |   | |   | |   |       |     | | | | |   | |
+-+ +-+-+-+ + +-+-+ +-+ + + +-+ + +-+-+ +-+ + +-+ +-+-+ + +-+
| | |     | | |   |     | | |     | | | | | |   |   | | | | |
+ + + + + + + + + +-+-+-+ + + +-+ + + + + + +-+ + + + +-+ + +
|     | |   |   |   |   | |     |   |   | | | | | | |     | |
+ + +-+-+-+ + +-+ + +-+ + + + +-+ + +-+-+ + + + +-+ +-+-+ + +
| | |       | |   | | |   | |   | | |       | |   | |     | |
+ +-+ + + +-+ + + + + + + + + + + +-+-+ + +-+ + + + + + +-+ +
| |   | | |   | | |   | |   | | |   | | | |   | |   | | |   |
+-+-+ +-+-+ + +-+-+-+ + +-+ +-+-+-+ + + + +-+ + + +-+ + +-+ +
| |       | | |   | | |   |     |   | | | | | | |   | | |   |
+ +-+ + + + + +-+ + +-+-+-+-+ + +-+-+ + + + + +-+-+ + +-+ +-+
|   | | | | |   | |     |     |       | |         | | |   | |
+-+ + + +-+ +-+-+ + + +-+-+ + +-+ + +-+ + +-+-+-+ +-+ + + + +
| | | |   | |   | | |   | | | | | | | | |   |     |   | | | |
+ + +-+ + + +-+ + + +-+-+ +-+ + + +-+ + +-+ + + + +-+ +-+ + +
| | |   | | |   |       |   | | | |       | | | | | | | | | |
+ + +-+-+-+ +-+ +-+-+-+ + + + + + + +-+-+-+-+ + +-+ + + + + +
| |     | |   | |     |   | |   |     | |   | |     | | |   |
+ + + +-+ + + + +-+ +-+ + + + + + + + + + + +-+ +-+-+ + +-+ +
|   | |   | |   |       | | | | | | | |   |       | | |     |
+ + +-+ +-+ + + + + +-+-+ + +-+-+-+ + + +-+ + +-+-+ + +-+ + +
| |         | |   | |     | | | | | | |   | |   |       | | |
+-+ +-+ +-+-+ +-+ + + +-+ +-+ + + + +-+-+-+ + + +-+ + +-+-+ +
| | |     | | | | | | | | |   | | | |     | | |   | | | |   |
+ + + +-+-+ + + +-+ +-+ + + + + + + + + + +-+ +-+ + +-+ + +-+
|   | |   | | |   | |       |     | | | |     | |   | |   | |
+ +-+-+ + + + + +-+-+ + +-+-+ + +-+-+-+ +-+-+-+ + +-+ + + + +
|   | | | |     | |   | |   | |   | | |   |   | |   | | |   |
+-+ + + + +-+-+ + + +-+ + + +-+ +-+ + +-+ + +-+ +-+ + +-+ + +
|   | | |   | | |     |   | |   |         | |     |   | | | |
+ + + + +-+ + +-+ + + + + +-+-+-+-+ + + + + + + +-+ + + + +-+
| | |     | |     | | | | | |     | | | | |   |     |       |
+ +-+ + + +-+ +-+-+ +-+ +-+ +-+ +-+ +-+ + +-+ + + + +-+ + +-+
|   | | | | |     |   | |   |         | |   | | | | | | |   |
+-+ + + +-+ +-+-+-+-+ +-+ +-+ + + + +-+ + + + +-+-+ + + +-+-+
| |   | | | | |   |   |   | | | | | |   | | | |   |   | |   |
+ + +-+-+ + + +-+ +-+ +-+ + + +-+-+-+ + + + + + + +-+ +-+-+ +
|         | | |   |   |   | |     |   | | | |   | |     |   |
+-+ + + + + + + + + + + + + + +-+-+-+-+ + +-+ + +-+ +-+ + +-+
| | | | | |   | |   |   | | |     | |   |   | |   |   | |   |
+ + + + +-+-+ +-+ + +-+-+-+ +-+-+ + + +-+-+ +-+ +-+-+-+-+ + +
| | | | | | |   | |   |     |     |   |       | | |   |   | |
+ + +-+-+ + + +-+-+ +-+ +-+ + + +-+ +-+ + + + +-+ + +-+ +-+ +
|   |                 | |   | | |     | | | |     |   | |   |
+ +-+ + + +-+ + +-+-+-+ +-+-+ + + + +-+ +-+-+-+-+-+ + + +-+-+
|   | | |   | | | |   | |   | | | | | |   | | |     |   | | |
+ +-+-+-+-+-+-+ + + + + + +-+ + + + + + + + + + +-+ +-+-+ + +
| |     |   | | | | |   | |   | | | |   | | | | | | |   |   |
+ + + + + + + + + + + +-+ +-+-+-+ +-+ +-+ + + + + + + + +-+ +
| | | | | |   |   | |   |       |   | | | | | |   |   | | | |
+ + +-+ + + +-+-+ + +-+ + +-+ + +-+-+ + + + + + + +-+-+ + + +
| |   |   |       | | | | | | |     | | |   |   | | | | | | |
+ + +-+ + + + + + + + + + + +-+-+ +-+ + +-+ + +-+-+ + + + + +
| |   | | | | | |   |           |   |                       |
+-+-+-+-+-+-+-+-+-+-+-+-+-+-+-+-+-+-+-+-+-+-+-+-+-+-+-+-+-+-+
